NO ./assets/east_textu re
SO ./assets/north_texture
        WE ./assets/south_texture
   EA ./assets/west_texture
F 220,  255,  0
C 225,30,0


1111111111111111111111111
100000000011000000011100111111111
10110000011100000001 100000000001
100100000000000000011100000000001
111111111011000001110000000000001
100000000011000001110111111111111
11110111111111011100000010001
11110111111111011101010010001
11000000110101011100000010001
1000000000000000110000010001
10000000000000001101010010001
11000001110101011111011110N0111
11110111 1110101 101111010001
11111111 1111111 111111111111