NO ./assets/east_textu re.xpm
SO ./assets/north_texture.xpm
        WE ./assets/south_texture.xpm
   EA ./assets/west_texture.xpm
F 220,  100,  0
C 225,30,0

1111111111111111111111111
1000000000110001000000001
1011000001110001000000001
1001000000000000S00000001
1111111111111111111111111