NO ./assets/east_texture
SO ./assets/north_texture
        WE ./assets/south_texture
   EA ./assets/west_texture
F 220,100,0
C 225,30,0


1111111111111111111111111
1000000000110001000000001
1011000001110001000000001
1001000000000000N00000001
1111111111111111111111111