1111111111111111111
1000000000000000001
1000000000111000001
1000000000001000001
100000000P001000001
1000000000001000001
1000000000000000001
1000000000000000001
1000000000000000001
1111111111111111111