NO ./assets/north.xpm
SO ./assets/south.xpm




        WE         ./assets/west.xpm
EA ./assets/east.xpm
C 225,30,0
F 220,100,0

1111111111111111111
1000000000000000001
1000000000111000001
1000000000001000001
1000000100001100001
1000000101001000001
1000000000000100001
1000000000000000001
1000000000N00000001
1111111111111111111