1111111111111111111
1000000000000000001
1000000100000000001
1000001010000000001
1000010001000000001
1000100001000000001
1000000000010000001
100000000P000000001
1000000000000000001
1111111111111111111