NO ./assets/north.xpm
SO ./assets/south.xpm




        WE         ./assets/west.xpm



EA ./assets/east.xpm


C 58,  222 ,233
F 183,139,89




11111111111111111111111111111
10000000001100000000000000001
101100000111000000000011110001
10010000000000000000011110001
11111111101100000111100000001
100011111111000001110111111001111111
11011       1111101110000001000000001
1S0001      111011101010010001111111
10001111111101011100000010001
10000000000000000000000010001
1111111100000000110101001001
        11000000010000000111111111111
        11000000000000000000000000001
        11111111111111111111111111111