NO ./assets/north.xpm
SO ./assets/south.xpm



        WE         ./assets/west.xpm
EA ./assets/east.xpm
C 193, 239, 255
F 222, 184, 135
1111111111111111111111111
1000000000110000000000001
1011000001110000000000001
1001000000000000000000001
11111111101100000111000001
1111111111111111111111111
100000000011    101110111111111111
100000000011    101110111111111111
100000000011    101110111111111111
11110111111111111100000010001
11110111111111011101010010001
11000000110101011100000010001
10000000000000001100000010001
10000N00000000001101010010001
1100000111010101111101111000111
11110111 1110101 101111010001
11111111 1111111 111111111111
