NO ./assets/north.xpm
SO ./assets/south.xpm




        WE         ./assets/west.xpm



EA ./assets/east.xpm


C 225,30,0
F 220,100,0




1111111111111111111
100000000000000000111111
100000000011100000000001
10000000000010000011111
1000000100001100001
1000000101001000001
1000000000000100001
100000100000001
1000000000N100000001
1111111111111111111