NO ./assets/north.xpm
SO ./assets/south.xpm




        WE         ./assets/west.xpm



EA ./assets/east.xpm


C 135,206,235
F 205,133,63




11111111111111111111111111111
10000000001100000000000000001
10110000011100 000000011110001
10010000000000000000011110001
11111111101100000111100000001
100011111111000001110111111001111111
11011         11101110000001000000001
1S0001      11101110101001000111111
10001111111101011100000010001
10000000000000000000000010001
1111111100000000110101001001
        11000000010000000111111111111
        11000000000000000000000000001
        11111111111111111111111111111