1111111
  11001111111111  
1111100000000111111111111111111111
1100000000000000000000000000000001
 110000000000000000000000000111111
  10000000000P000000000000001
  100000000000000000000000001
  100000000000000000000000011
  111100001111111111111111111
     100001
     100001 111111
   11100001 100001
   1000001 100001
111110000111100001
111001000000011111
110011100111111
10011  1000001
10011  1000001
11111  1111111