11111111111111111111111111111
10000000001100000000000000001
10110000011100000000011110001
10010000000000000P00011110001
11111111101100000111100000001
10001111111100000111011111111
11011      111011100000010001
10001      111011101010010001
10001111110101011100000010001
10000000000000000000000010001
11111111100000000110101001001
        11000000010000000111011111111
        11000000000000000000000000001
        11111111111111111111111111111