11111111111111111111111111111
10000000001100000P00000000001
10110000011100000000011110001
10010000000000000000011110001
11111111101100000111100000001
10000000001100000111011111111
11110      111011100000010001
11110      111011101010010001
11000000110101011100000010001
10000000000000001100000010001
11111111100000000110101001001
        11000001110101011111011111111
        11110111011101000101111010001
        11111111111111111111111111111